10
P.B.-.-.-.-.-.-.B.P
B.-.B.-.-.-.-.-.-.B
-.B.P.B.S.-.-.-.-.-
B.-.G.-.S.G.-.S.-.-
P.BS.-.-.G.-.S.W.S.-
-.S.S.W.S.-.G.B.P.B
-.-.-.S.-.B.-.G.B.B
-.-.A.-.B.P.B.-.B.P
-.B.-.G.-.-.-.G.-.-
B.P.B.-.-.G.-.-.-.-