10
S.-.G.-.-.-.-.-.-.-
W.S.-.P.-.G.-.-.-.-
S.G.B.-.-.-.S.G.-.-
-.B.P.B.-.S.W.S.S.-
-.-.B.P.B.-.S.S.W.S
-.-.-.B.P.B.-.-.S.-
-.-.-.-.B.P.B.-.-.S
-.G.-.-.-.B.P.B.S.W
-.-.-.-.-.-.B.P.B.S
-.-.-.A.-.-.-.B.-.G