10
G.G.-.-.-.-.-.-.G.G
G.G.-.B.P.B.-.-.G.G
-.-.-.-.BS.P.B.-.-.-
B.-.-.-.W.BS.-.B.-.-
P.B.-.-.-.W.BS.P.B.-
B.P.B.-.-.-.-.B.-.B
-.B.-.-.-.-.-.-.B.P
-.-.-.-.-.-.-.-.-.B
G.G.-.-.-.-.-.-.G.G
G.G.-.-.-.A.-.-.G.G